XXXXXXXXXXXXXXXXXXXXXXXXXXXXXXXXXXXXXXXXXXXXXXXXXXXXXXXXXXXXXXXXXXXXXXXXXXXXXXXXXXXXXXXXXXXXXXXXXXXXXXXXXXXXXXXXXXXXXXX
X                                                         XX                                                          X
X                                                         XX                                                          X
X                                                 X       XX                                                          X
X                                                 X       XX                                                          X
X                                                 X       XX                                                          X
X                                                QX       XX                                                         OX
XXXXXXXXXXXXXXXXXXXXXXXXXXXXXXXXXXXXXXXXXXXXXXXXXXX       XX            XXXXXXXXXXXXXXXXXXXXXXXXXXXXXXXXXXXXXXXXXXXXXXX
X                                                         XXXXXXXXX                                                   X
X                                                         XX                                                          X
X                                                         XX                                                          X
X                                                         XX      XXXXXX                                              X
X                       X                        W        XX                                                          X
X                       XXXXXXXXXXXXXXXXXXXXXXXXXXXXXXXXXXXXXXXXXXXXXXXXXXXXXXXXXXXX     XXXXXXXXXXXXXXXXXXXXXXXXXXXXXX
X                                                         XX                                                          X
X                                                         XX                                                          X
X                                                         XX                                                         EX
XP                                                        XX         XXXXXXXXXXXXXXXXXXXXXXXXXXXXXXXXXXXXXXXXXXXXXXXXXX
XXXXXXX                                                   XXP                                                         X
X                                                         XXXXXXXX                                                    X
X                                                         XX                                                          X
X                       X   Q                             XX        XXXXXXXXXXXX                                      X
X                       XXXXXXXXXXXXXXXXXXXXXXXXXXXXXXXXXXXX                                                          X
X                                                         XX                       XXXXXXXX                           X
X                                                         XX                                                          X
X                                 XX                      XX                 XXXXXX       XXXXXXX                     X
X                                 XX                      XX                                                          X
X                                 XX                      XX                                                          X
X                            Q    XX                      XX             XXXXX                    XXXXXX              X
XXXXXXXXXXXXXXXXXXXXXXXXXXXXXXXXXXXX                      XX                                                          X
X                                                         XX          XXX                                             X
X                                                         XX                     XXXXXX               XXXXXX          X
X                                   XX      XX            XX       XXXXX         XXXXXX               XXXXXX          X
X                                  XXX      XXX           XX                                                          X
X                                 XXXX      XXXX          XX                                                          X
XQ     W                  W     QXXXXX      XXXXXQ      Q XXXXXXXX         XXXXXX               XXXXXX                X
XXXXXXXXXXXXXXXXXXXXXXXXXXXXXXXXXXXXXX      XXXXXXXXXXXXXXXX                                                          X
X                                                         XX      XXX                              XXXXXX             X
X                                                         XX                    XXXXXX                                X
X                     XXXXXX     XXXXX                    XX      XXXXXX                                              X
X             X                                           XX                        XXXXXX               XXXXXX       X
X             X                                           XX                                                          X
X             X      Q                              Q     XX            XXXXXX                         XXXXXX         X
X             XXXXXXXXXXXXXXXXXXXXXXXXXXXXXXXXXXXXXXXXXXXXXX        XXX                   XXXXXX                      X
X                                                         XX                                                          X
X                                                         XXXXXXXX                  XXXXXX                            X
X                                         X               XX                                                          X
X                    Q                    X               XX                     XXXXXX                               X
XXXXXXXXXXXXXXXXXXXXXXXXXXXXXXXXXXXXXXXXXXX               XX      XXXXXX                                              X
X                                                         XX                                                          X
X                                                         XX           XXXXX                                          X
X           W  Q                                          XX                        XXXXXX                            X
X           XXXXXXXXXXXXXXXXXXXXXXXXXXXXXXXXXXXXXXXXXXXXXXXX                  XXXXXX                                  X
X                                                         XX                                                          X
X                                                         XX                                                          X
X                                                         XX               XXXXXX                                     X
X                                                                                                                     X
X                                                                                 XXXXXXX                             X
X                                                                                                                     X
XT                        R                                                                      R                   TX
XXXXXXXXXXXXXXXXXXXXXXXXXXXXXXXXXXXXXXXXXXXXXXXXXXXXXXXXXXXXXXXXXXXXXXXXXXXXXXXXXXXXXXXXXXXXXXXXXXXXXXXXXXXXXXXXXXXXXXX
